# Map file for tile-based game 
# (Lines that start with '#' are comments)
# The tiles are:
#   (Space) Empty tile
#   A..Z    Tiles A through Z
#   o       Star
#   !       Music Note
#   *       Goal
#   1       Bad Guy 1 (grub)
#   2       Bad Guy 2 (fly)
BF          o o o                o o o o o o o o o o o o o o o o o o o o o o o                EB
AD         IIIIIII              IIIIIIIIIIIIIIIIIIIIIIIIIIIIIIIIIIIIIIIIIIIIIII               CA
AD                      o o o                I                   EBBBBBBBBBBBBBF     o o o o  CA
AD                     IIIIIII               I                   CAAAAAAAAAAAAAD    o o o o o CA
AD            I                              I             o o   CAAAAAAAAAAAAAHF    o o o o  CA
AD                 I  2   !        2                      IIIII  CAAAAAAAAAAAAAAD   o o o o o CA
AD                      IIIII                                    CAAAAAAAAAAAAAAHF   IIIIIII  CA
AD         III                          1    1  1        2       CAAAAAAAAAAAAAAAD  o o o o o CA
AD                            1      IIIIIIIIIIIII               CAAAAAAAAAAAAAAAHF  o o o o  CA
AD      1       EBBBBBBBBBBBBBBBF     o o o o o o                CAAAAAAAAAAAAAAAAD o o o o * CA
AH          BBBBGAAAAAAAAAAAAAAAH   BBBBBBBBBBBBBBBBBBBBBBBBBBBBBGAAAAAAAAAAAAAAAAHBBBBBBBBBBBGA
BF          o o o                o o o o o o o o o o o o o o o o o o o o o o o                EB
AD         IIIIIII              IIIIIIIIIIIIIIIIIIIIIIIIIIIIIIIIIIIIIIIIIIIIIII               CA
AD                      o o o                I                   EBBBBBBBBBBBBBF     o o o o  CA
AD                     IIIIIII               I                   CAAAAAAAAAAAAAD    o o o o o CA
AD            I                              I             o o   CAAAAAAAAAAAAAHF    o o o o  CA
AD                 I  2   !        2                      IIIII  CAAAAAAAAAAAAAAD   o o o o o CA
AD                      IIIII                                    CAAAAAAAAAAAAAAHF   IIIIIII  CA
AD         III                          1    1  1        2       CAAAAAAAAAAAAAAAD  o o o o o CA
AD                            1      IIIIIIIIIIIII               CAAAAAAAAAAAAAAAHF  o o o o  CA
AD      1       EBBBBBBBBBBBBBBBF     o o o o o o                CAAAAAAAAAAAAAAAAD o o o o o CA
AHBBBBBBBBBBBBBBGAAAAAAAAAAAAAAAHBBBBBBBBBBBBBBBBBBBBBBBBBBBBBBBBGAAAAAAAAAAAAAAAAHBBBBBBBBBBBGA